  R  1920 1080

NO ./images/choongus.xpm
EA ./images/stone.xpm
SO  ./images/purple stone.xpm     
 WE  ./images/metal.xpm   

S ./images/greenlight.xpm

      F     56,56,56
C     88,0,88

111111111111111111111111
100000000000000000000001
100020000000000002200001
100000000000000000000001
100000111110000101010001
100000100010000200000001
100000100010000100010001
100000100010000000000001
100000110110000101010001111111111111111111
100000000000000000000000000000000000000001
100000000000000000000001111111111111111111
100000000111000000000001
1000000001 1000000000001
100000000111000000000001
100000000000000000000001
100000000000000000000001
111111111000000000000001
110100001000000000000001
11000000100000000N000001
110100001000000000000001
110111111000000000000001
110000000000000000000001
111111111000000000000001
111111111111111111111111