R    1920    1080

NO ./path_to_the_north_texture
SO      ./path_to_the_south_texture
WE  ./path_to_the_west_texture
EA ./path_to_the_east_texture

S ./sprites/choongus.png

F     110,178,25
C     135,206,250

111111111111111111111111
100000000000000000000001
100000000000000000000001
100000000000000000000001
100000111110000101010001
100000100010000000000001
10000010001000010N010001
100000100010000000000001
100000110110000101010001111111111111111111
100000000000000000000000000000000000000001
100000000000000000000001111111111111111111
100000000000000000000001
100000000000000000000001
100000000000000000000001
100000000000000000000001
100000000000000000000001
111111111000000000000001
110100001000000000000001
110000001000000000000001
110100001000000000000001
110111111000000000000001
110000000000000000000001
111111111000000000000001
111111111111111111111111