  R   1700 1000

NO ./images/jajasies.png
SO  ./images/purple stone.png     
 WE  ./images/eagle.xpm   
EA ./images/cheeze.png  

S ./images/barrel.xpm

      F     110,178,25
C     135,206,250

111111111111111111111111
100000000000000000000001
100020000000S00002200001
100000000000000000000001
100000111110000101010001
100000100010220000000001
100000100010000100010001
100000100010000000000001
100000110110000101010001111111111111111111
100000000000000000000000000000000000000001
100000000000000000000001111111111111111111
100000000111000000000001
1000000001 1000000000001
100000000111000000000001
100000000000000000000001
100000000000000000000001
111111111000000000000001
110100001000000000000001
110000001000000000000001
110100001000000000000001
110111111000000000000001
110000000000000000000001
111111111000000000000001
111111111111111111111111