R 1920 1080
NO ./images/greystone.xpm
SO ./images/redbrick.xpm
EA ./images/wood.xpm
WE ./images/wood.xpm
S ./images/barrel.xpm
S1 ./images/barrel.xpm
C 255,200,160
F 122,122,122

11111111111111111
10000000000000001
10000000200000001
10000000200000101
10000000000002001
10000000000000021
10000000N00000001
10000000000000001
10000000000000001
10000000000000001
10000000000000001
10000000000000001
11111111111111111