R 1920 1080
NO images/wall.xpm
SO images/stone.xpm
WE images/wood.xpm
EA images/metal.xpm
S  images/choongus.xpm
    F  123 ,  90 ,  90
    C  81 ,  0 ,118

    111111111111111111111111
    100000000000000000000001
    111111111111111111111111
    100000000000000000E00101
1111100000000000000000000001
1000001111100001010100011111
100000100010200000000001
100000100010000100010001
100000100010000000000001
100000110110000101010001
100000000000000000000001
100000000011100000000001
10000002001 100000000001
100000000011100020000001
100000000000000000000001
100000000000000000000001
100000000000000000000001111
111111111000020000000001001
110100001000000000000001111
110000001000000000000001
100000001000000000000001
11111100000000000000000111111
     100000000000000000000001
     100000000000000000000001
     111111111111111111111111
